wwwwwwwwwwwwwwwwwwwwwwwwwwwwwwwwwwwwwwwwwwwwwwwwwwwwwwwwwwwwwwwwwwwwwwwwwwwwwwwwwwwwwwwwwwwwwwww
w--------------w-----------------------------------w-------------------------------------------w
w--------------w-----------------------------------w-------------------------------------------w
w-----p--------w-----------------------------------w-------------------------------------------w
w--------------w-----------------------------------w-------------------------------------------w
w--------------w-------------------------w---------w-------------------------------------------w
w--------------w-------------------------w---------w-------------------------------------------w
w--------------w-------------------------w---------wwww-----wwwwwwwwwwwwwwwwwwwwwwwwwwwwww-----w
w--------------wwwwwwwwwwwwww------------w---------w--------------------------w----------------w
w----------------------------------------w---------w--------------------------w----------------w
w----------------------------------------w---------w--------------------------w----------------w
w----------------------------------------w---------w--------------------------w----------------w
wwwwwwwwwwwwwwwwwwwwwwwwwwwwwwwwwwwwwwwwww---------w---e------------w---------w----------------w
w----------------------------------------w---------w----------------w---------w----------------w
w----------------------------------------w---------w----------------w---------w----------------w
w----------------------------------------w---------w----------------w---------w----------------w
w----------------------------------------w--------------------------w---------w----------------w
w----------------------------------------w--------------------------w---------w----------------w
w------------wwwwwwwwwwwwwwwwwwwwwwwwwwwwwwwwwwwwwwwwwwwwwwww-------w---------w----------------w
w------------w-------------w-------------w------------------w-------w---------w----------------w
w------------w-------------w-------------w------------------w-------w---------w----------------w
w------------w-------------w-------------w------------------wwwwwwwww---------w----------------w
w------------w-------------w-------------w------------------w-----------------w----------------w
w------------w-------------w-------------w------------------w-----------------w----------------w
w------------w-------------w-------------w------------------w-----------------w----------------w
w------------w-------------w-------------w------------------w--------e--------w----------------w
w------------w-------------w-------------w------------------w-----------------w----------------w
w------------w------------------------------------------g---w----------------------------------w
w-----------------------------------------------------------w----------------------------------w
w---------------------------wwwwwwwwwwwwwwwwwwwwwwwwwwwwwwwww----------------------------------w
w------------w----------------------------------------------w-------wwwwwwwwwwwwwwwwwwwwwwwwwwww
w------------w----------------------------------------------w-----------------------w----------w
w------------w----------------------------------------------w-----------------------w----------w
w------------w------------------------------------w---------w-----------------------w----------w
w------------w---------e--------------------------w---------w-----------------------w----------w
w------------w------------------------w-----------w---------w-----------------------w----------w
w------------w------------------------w-----------w---------w-----------------------w----------w
wwwwwwwwwwwwwwwwwwwwwwwwwwwwwwwwwwwwwww-----------w---------w-----------------------w----------w
w-------------------------------------w-----------w---------w-----------------------w----------w
w-------------------------------------w-----------wwwwwwwwwwwwwwwwwwwwwwww----------w----------w
w-------------------------------------w---------------------------------------------w----------w
w-------------------------------------w---------------------------------------------w----------w
w-----------------w-------------------w---------------------------------------------w----------w
w-----------------w-------------------w-------------------------------w-------------w----------w
w-----------------w-------------------w-------------------------------w-------------w----------w
w-----------------wwwwwwwwwwwwwwwwwwwwwwwwwwwwwwwwwwwwwwwwwwwww-------w-------------w----------w
w-----------------w-------------------w-------------------------------w-------------w----------w
w-----------------w-------------------w-------------------------------w-------------w----------w
w-----------------w-------------------w-------------------------------w-------------w----------w
w-----------------w-------------------w-------------------------------w-------------w----------w
w-----------------w-------------------w-------------------------------w------------------------w
w---------------------------------------------------------------------w------------------------w
w---------------------------------------------------------------------w------------------------w
wwwwwwwwwwwwwwwwwwwwwwwwwwwwwwwwwwwwwwwwwwwwwwwwwwwwwwwwwwwwwwwwwwwwwwwwwwwwwwwwwwwwwwwwwwwwwwww
