wwwwwwwwwwwwwwwwwwwwwwwwwwwwwwwwwwwwwwwwwwwwwwwwwwwwwwwwwwwwwwwwwwwwwwwwwwwwwwwwwwwwwwwwwwwwwwww
w----------------------------------------------------------------------------------------------w
w----------------------------------------------------------------------------------------------w
w----------e--------e--------------------------------------------------------------------------w
w----------------------------------------------------------------------------------------------w
w------e---------------------------------------------------------------------------------------w
w--------------wwwwwwwwwwwwwwwwwwwwwwwwwwwwwwwwwwwwwwwwwwwwwwwwwwwwwwwwwwwwwwwww---------------w
w--------------w---------------------------------------------------------------w---------------w
w--------------w---------------------------------------------------------------w---------------w
w--------------w---------------------------------------------------------------w---------------w
w--------------w------e--------------------------------------------------------w---------------w
w--------------w---------------------------------------------------------------w---------------w
w--------------w------e--------------------------------------------------------w---------------w
w--------------w--------------wwwwwwwwwwwwwwwwwwwwwwwwwwwwwwwwww---------------w---------------w
w--------------w--------------w--------------------------------w---------------w---------------w
w--------------w------e-------w--------------------------------w---------------w---------------w
w--------------w--------------w--------------------------------w---------------w---------------w
w--------------w--------------w--------------------------------w---------------w---------------w
w--------------w--------------w--------------------------------w---------------w---------------w
w--------------w--------------w--------------------------------w---------------w---------------w
w--------------w--------------w--------------w-----------------w---------------w---------------w
w--------------w--------------w--------------w-----------------w---------------w---------------w
w--------------w--------------w--------------w--------e--------w---------------w---------------w
w--------------w--------------w--------------w-----------------w---------------w---------------w
w--------------w--------------w--------------w-----------------w---------------w---------------w
w--------------w--------------w--------------w----e---g---e----w---------------w---------------w
w--------------w--------------w--------------w-----------------w---------------w---------------w
w--------------w--------------w--------------w-----------------w---------------w---------------w
w--------------w--------------w--------------w--------e--------w---------------w---------------w
w--------------w--------------w------e-------w-----------------w--------e------w---------------w
w--------------w--------------w--------------wwwwwwwwwwwwwwwww-w---------------w---------------w
w--------------w--------------w------------------------------------------------w---------------w
w--------------w--------------w-------e---------------------------------e------w---------------w
w--------------w--------------w------------------------------------------------w---------------w
w--------------w--------------w-------e----------------------------------------w---------------w
w--------------w--------------w----------------------------------------e-------w---------------w
w--------------w--------------w------------------------------------------------w---------------w
w--------------w--------------w------------------------------------------------w---------------w
w--------------w--------------wwwwwwwwwwwwwwwwwwwwwwwwwwwwwwwwwwwwwwwwwwwwwwwwww---------------w
w--------------w-------------------------------------------------------------------------------w
w--------------w-------------------------------------------------------------------------------w
w--------------w---------------------------------------------------e---------------------------w
w--------------w-----------------------------------------------------------e-------------------w
w--------------w-------------------------------------------e-----------------------------------w
w---e----------w-------------------------------------------------------------------------------w
w---------e----w-------------------------------------------------------------------------------w
w--------------wwwwwwwwwwwwwwwwwwwwwwwwwwwwwwwwwwwwwwwwwwwwwwwwwwwwwwwwwwwwwwwwwwwwwwwwwwwwwwwww
w----------------------------------------------------------------------------------------------w
w----------------------------------------------------------------------------------------------w
w---------e------------------------------------------------------------------------p-----------w
w----------------------------------------------------------------------------------------------w
w----------------------------------------------------------------------------------------------w
w----------------------------------------------------------------------------------------------w
wwwwwwwwwwwwwwwwwwwwwwwwwwwwwwwwwwwwwwwwwwwwwwwwwwwwwwwwwwwwwwwwwwwwwwwwwwwwwwwwwwwwwwwwwwwwwwww
