wwwwwwwwwwwwwwwwwwwwwwwwwwwwwwwwwwwwwwwwwwwwwwwwwwwwwwwwwwwwwwwwwwwwwwwwwwwwwwwwwwwwwwwwwwwwwwww
w----------------------------------------------------------------------------------------------w
w----------------------------------------------------------------------------------------------w
w-------------------------------------------------------------------------------------w--------w
w-------------------------------------------------------------------------------------wwwwwwwwww
w--------------wwwwwwwwwwwwwwwwwwwwwwwwwwwwwwwww-----------------------------------------------w
w----------------------------------------------w-----------------------------w-----------------w
w----------------------------------------------w-----------------------------w-----------------w
w------------------------e---------------------w-----------------------------w---------e-------w
w----------------------------------------------w-----------------------------w-----e-----------w
w----------------------------------------------w-----------------------------w-----------------w
w--------------s----e----g----e----------------w-----------------------------w-----------------w
w----------------------------------------------w-----------------------------w-------e---------w
w----------------------------------------------w--------------e--------------w-----------------w
w------------------------e---------------------w-----------------------------w-----------------w
w----------------------------------------------w-----------------------------w-----------------w
w----------------------------------------------w-----------------------------w-----e-----------w
wwwwwwwwwwwwwwwwwwwwwwwwwwwwwwwwwww------------w-----------------------------w-----------------w
w----------------------------------------------w-----------------------------w-----------------w
w----------------------------------------------w-----------------------------w-----------------w
w----------e-----------------------------------w----------------e------------w-----------------w
w--------------------e-------------------------w-----------------------------w-----------------w
w----------------------------------------------w-----------------------------w-----------------w
w----------------------------------------------w-----------------------------w----------e------w
w-----------wwwwwwwwwwwwwwwwwwwwwwwwwwwwwwwwwwww-----------------------------w-----------------w
w----------------------------------------------w-----------------------------w-----------------w
w----------------------------------------------w-----------------------------w-----------------w
w----------------------------------------------w-----------------------------w-----------------w
w----------------------------------------------w-----------------------------w-----------------w
w-------------------------------------e--------w----------w------------------w-----------------w
w----------------------------------------------w----------w------------------w-------e---------w
w----------------------------------------------w----------w------------------w-----------------w
wwwwwwwwwwwwwwwwwwwwwwwwwwwwwwwww--------------w----------w------------------w-----------------w
w----------------------------------------------w----------w------------------w-----------------w
w----------------------------------------------w----------w------------------w-----------------w
w-----------w-----------------------w----------w----------w------------------w-----------------w
w-----------w-----------------------w----------w----------w------------------w-----------------w
w-----------w-----------------------w----------w----------w------------------w----------e------w
w-----------w-----------------------w----------w----------w------------------w-----------------w
w-----------w-----------w-----------w----------w----------w------------------w-----------------w
w-----------w-----------w-----------w----------w----------w------------------w-----------------w
w-----------w-----------w-----------w----------w----------w------------------w-----------------w
w-----------w-----------w-----------w----------w----------w------------------w-----------------w
w-----------w-----------w-----------w----------w----------w------------------w-----------------w
w-----------w-----------w-----------w----------w----------w------------------w-----------------w
w-----------w-----------w-----------w----------w----------w------------------w-----------------w
w-----------w-----------w-----------w---------------e-----w------------------w-----------------w
w-----------w-------e---w-----------w---------------------w------------------w-----------------w
w-----------w-----------w-----------w---------------------w------------------w-------p---------w
w----------------------------------------------------------------------------w-----------------w
w----------------------------------------------------------------------------w-----------------w
w----------------------------------------------------------------------------w-----------------w
w----------------------------------------------------------------------------w-----------------w
wwwwwwwwwwwwwwwwwwwwwwwwwwwwwwwwwwwwwwwwwwwwwwwwwwwwwwwwwwwwwwwwwwwwwwwwwwwwwwwwwwwwwwwwwwwwwwww
