wwwwwwwwwwwwwwwwwwwwwwwwwwwwwwwwwwwwwwwwwwwwwwwwwwwwwwwwwwwwwwwwwwwwwwwwwwwwwwwwwwwwwwwwwwwwwwww
w----------------------------------------------------------------------------------------------w
w----------------------------------------------------------------------------------------------w
w-------------------e---------------------------------e----------------------------------------w
w-------------------------------------------------------------------------e--------------------w
w------e---------------------------e-----------------------------------------------------------w
w--------------wwwwwwwwwwwwwwwwwwwwwwwwwwwwwwwwwwwwwwwwwwwwwwwwwwwwwwwwwwwwwwwww---------------w
w--------------w---------------------------------------------------------------w---------------w
w--------------w---------------------------------------------------------------w---------e-----w
w--------------w---------------------------------------------------------------w---------------w
w--------------w------e--------------------------------------------------------w---------------w
w--------------w-----------------------------------------e---------------------w---------------w
w--------------w---------------------------------------------------------------w---------------w
w-e------------w--------------wwwwwwwwwwwwwwwwwwwwwwwwwwwwwwwwww---------------w---------------w
w--------------w--------------w--------------------------------w---------------w---------------w
w--------------w--------------w--e-----------------------------w---------------w---------------w
w--------------w--------------w--------------------------------w---------------w---------------w
wwww-----------w--------------w-----------------------wwwwwwwwww---------------w---------------w
w--------------w----------e---w--------------------------------w-----------e---w---------------w
w--------------w--------------w--------------------------------w---------------w-------e-------w
w--------------w--------------w--------------w-----------------w---------------w---------------w
w--------------w--------------w--------------w-----------------wwwwwwww--------w---------------w
w--------------w--------------wwwwww---------w--------s--------w---------------w---------------w
w------------e-w--------------w--------------w-----------------w---e-----------w---------------w
w--------------w--------------w--------------w-----------------w---------------w---------------w
w--------------w--------------w---------e----w----e---g---e----w---------------w---------------w
w--------------w--------------w---e----------w-----------------w---------------w---------------w
w-----------wwww--------------w--------------w-----------------w---------------w-----------e---w
w--------------w--------------w--------------w--------s--------w---------------w---------------w
w--------------w--------------w--------------w-----------------w---------------w---------------w
w--------------w--------------w-----e--------wwwwwwwwwwwwwwwwwww---------------w---------------w
w--------------w-----e--------w--------------------------------------e---------w---------------w
w--------------w--------------w------------------------------------------------w---------------w
w--------------w--------------w------------------------------------------------w---e-----------w
w--------------w--------------w-----------w------------------------------------w---------------w
w--------------w--------------w-----e-----w--------------------------e---------w---------------w
w--------------w--------------w-----------w--------------e---------------------w---------------w
w--------------w--------------w-----------w------------------------------------w---------------w
w--------------w--------------wwwwwwwwwwwwwwwwwwwwwwwwwwwwwwwwwwwwwwwwwwwwwwwwww---------------w
w--------------w-------------------------------------------------------------------------------w
w--------------w-------------------------------------------------------------------------------w
w--------------w------e------------------------------------------------------------------e-----w
w--------------w------------------e-----------------------------------------e------------------w
w------e-------w-------------------------------------------e-----------------------------------w
w--------------w---------------------------e---------------------------------------------------w
w---e-----e----w-------------------------------------------------------------------------------w
w--------------wwwwwwwwwwwwwwwwwwwwwwwwwwwwwwwwwwwwwwwwwwwwwwwwwwwwwwwwwwwwwwwwwwwwwwwwwwwwwwwww
w--------------w-------------------------------------------------------------------------------w
w--------------w-------------------------------------------------------------------------------w
w--------------w-------------------------------------------------------------------p-----------w
w----------------------------------------------------------------------------------------------w
w----------------------------------------------------------------------------------------------w
w----------------------------------------------------------------------------------------------w
wwwwwwwwwwwwwwwwwwwwwwwwwwwwwwwwwwwwwwwwwwwwwwwwwwwwwwwwwwwwwwwwwwwwwwwwwwwwwwwwwwwwwwwwwwwwwwww
