wwwwwwwwwwwwwwwwwwwwwwwwwwwwwwwwwwwwwwwwwwwwwwwwwwwwwwwwwwwwwwwwwwwwwwwwwwwwwwwwwwwwwwwwwwwwwwww
w------------------------------------------w-------w-------------------------------------------w
w------------------------------------------w---s---w-------------------------------------------w
w------------------------------------------w-------w-------------------------------------------w
w------------------------------------------w-e-g-e-w-------------------------------------------w
w------------wwwwwwwwwwww------------------w-------w------------------wwwwwwwwwwww-------------w
w-----------------------w------------------w---e---w------------------w------------------------w
w-----------------------w------------------w-------w------------------w------------------------w
w-----------------------w--------e---------ww--e--ww---------e--------w------------------------w
w-----------------------w-------------------w-----w-------------------w------------------------w
w----------e------------w-------------------w-----w-------------------w------------e-----------w
w-----------------------w--------e----------w-----w----------e--------w------------------------w
w-----------------------w-------------------w--e--w-------------------w------------------------w
w-----------------------w-------------------w-----w-------------------w------------------------w
w-----------------------w-------------------w-----w-------------------w------------------------w
wwwwwww-----------------wwwwwwwwwwwwwwwwwwwww-----wwwwwwwwwwwwwwwwwwwww------------------wwwwwww
w--------------------------------w--------w---------w--------w---------------------------------w
w--------------------------------w--------w---------w--------w---------------------------------w
w--------------------------------w--------w----e----w--------w---------------------------------w
w----------------------e----e----w---------------------------w----e----e-----------------------w
w--------------------------------w---------------------------w---------------------------------w
w--------------------------------w------------www------------w---------------------------------w
w----------------wwwwwwwwwwwwwwwww---------------------------wwwwwwwwwwwwwwwww-----------------w
w--------------------------------w---------------------------w---------------------------------w
w--------------------------------w---------www---www---------w---------------------------------w
w--------------------------------w-----------w---w-----------w---------------------------------w
w--------------------------------w-----------w---w-----------w---------------------------------w
w--------------------------------wwwww-------w---w-------wwwww---------------------------------w
w--------------------------------w-----------w---w-----------w---------------------------------w
w--------------------------------w-----------w---w-----------w---------------------------------w
w--------------------------------w--------wwww---wwww--------w---------------------------------w
w--------------------------------w--------w---------w--------w---------------------------------w
w--------------------------------w--------w---------w--------w---------------------------------w
w-----------------------------------------w---------w------------------------------------------w
w----------------------------------------------------------------------------------------------w
w--------wwwwwwwwwwwwwwwwwwwwww---------------------------------wwwwwwwwwwwwwwwwwwwwww---------w
w--------w------w-------------w---------------------------------w-------------w------w---------w
w--------w------w-------------w---------------------------------w-------------w------w---------w
w--------w------w------e------w---------------------------------w------e------w------w---------w
w--------w------w-------------w---------------------------------w-------------w------w---------w
w--------w------w-------------w---------------------------------w-------------w------w---------w
w---------------w-------------w---------------------------------w-------------w----------------w
w---------------w-------------w---------------------------------w-------------w----------------w
w---------------w-------------------------------------------------------------w----------------w
w---------------w-------------------------------------------------------------w----------------w
w---------------w-------------------------------------------------------------w----------------w
w---------------w-------------------------------------------------------------w----------------w
w---------------wwwwwwwwwwwwwwwwwwwwwwwwwwwwww---wwwwwwwwwwwwwwwwwwwwwwwwwwwwww----------------w
w--------------------------------------------w---w---------------------------------------------w
w--------------------------------------------w---w---------------------------------------------w
w----------e---------------------------------w---w---------------------------------e-----------w
w--------------------------------------------w-p-w---------------------------------------------w
w--------------------------------------------w---w---------------------------------------------w
wwwwwwwwwwwwwwwwwwwwwwwwwwwwwwwwwwwwwwwwwwwwwwwwwwwwwwwwwwwwwwwwwwwwwwwwwwwwwwwwwwwwwwwwwwwwwwww
