wwwwwwwwwwwwwwwwwwwwwwwwwwwwwwwwwwwwwwwwwwwwwwwwwwwwwwwwwwwwwwwwwwwwwwwwwwwwwwwwwwwwwwwwwwwwwwww
w----------w---------------------------------w--------------------------w----------------------w
w----p-----w---------------------------------w--------------------------w----------------------w
w----------w---------------------------------w--------------------------w----e-----------------w
w----------w---------------------------------w------------w-------------w----------------------w
w----------w---------------------------------w------------w-------------w----------------------w
w----------wwwwwwwwwwwwwwwwwwww--------------w------------w-------------w----------------------w
w-----------------------------w--------------w------------w-------------w----------------------w
w-----------------------------w-------e------w------------w-------------wwwwwwwwwwwww----------w
w-----------------------------w--------------w------------w-------------w-----------w----------w
w----------w------------------w--------------w------------w-------------w-----------w----------w
w----------w------------------w--------------w------------w------e------w-----------w----------w
w----------w------------------w--------------w------------w-------------w-----e-----w----e-----w
w----------w----------------------------------------------w-------------w-----------w----------w
w----------w----------------------------------------------w-------------w-----------w----------w
w----------wwwwwwwwwwwwwwwwwwwwwwwwwwwwwwwwwwwwwwwwwwwwwwwwwwwwwwwwwwwwww-----------w----------w
w--------------------------w--------------------------------------------------------w----------w
w--------------------------w--------------------------------------------------------w----------w
w--------------------------w--------------------------------------------------------w----------w
wwwwww---------------e-----w--------------------------------------------------------w----------w
w----w---------------------w------wwwwwwwwwwwwwwwwwww-------------------------------w----------w
w----w---------------------w------w------------------------------------------------------------w
w----w-----------wwwwwwwwwww------w-------------------------wwwwwwwwwwwwwwwwwww----------------w
w----w---------------------w------w-------------------------------------------w----------------w
w----w---------------------w------w-------------------------------------------w----------------w
w----w---------------------w------w------e--------------------------e---------w----e-----------w
w----w----------------------------w-------------------------------------------w----------------w
w----w---------------e------------w-------------------------------------------w----------------w
w----w----------------------------w--------------wwwwwwwwwwwwwwwwwwwwwwwwwwwwwwwwwwwwwww-------w
w----w----------------------------w--------------w-----------------w---------------------------w
w----w------------wwwwwwwwwwwwwwwww--------------w-----------------w---------------------------w
w----w-------------------------------------------w-----------------w---------------------------w
w----w-------------------------------------------w-------e---------w---------------------------w
w----w-------------------------------------------------------------w---------w-----------------w
w----w-------------------------------------------------------------w---------w--------e--------w
w----w-------------------------------------------------------------w---------w-----------------w
w----wwwwwwww------wwwwwwwwwwwwwwwwwwwwwwwwwwwwwwwwwwwwww----------w---------w-----------------w
w------------------w-------------------w----------------w----------w---------w-----e--g--e-----w
w------------------w-------------------w----------------w----------w---------w-----------------w
w------------------w-------------------w----------------w----------w---------w-----------------w
w------------------w-------------------w----------------w----------w---------w--------e--------w
w------w-----------w-------------------w-------e-------------------w---------w-----------------w
w------w-----------w----------w--------w---------------------------w---------wwwwwwwwwwwwwwwwwww
w------w-----e-----w----------w--------w-------------------------------------------------------w
w------w-----------w----------w--------w-------------------------------------------------------w
w------w-----------w----------w--------w-------------------------------------------------------w
w------w-----------w----------w--------wwwwwwwwwwwwwwwwwwwwwwwwwwwwwwwwwwwwwwwwwww-------------w
w------wwwwwwwwwwwww----------w---------------------w------------------------------------------w
w-----------------------------w---------------------w-----------------------------------e------w
w-----------------------------w---------------------w------------------------------------------w
w-----------------------------w----------e----------w----------e-------------------------------w
w-----------------------------w----------------------------------------------------------------w
w-----------------------------w----------------------------------------------------------------w
wwwwwwwwwwwwwwwwwwwwwwwwwwwwwwwwwwwwwwwwwwwwwwwwwwwwwwwwwwwwwwwwwwwwwwwwwwwwwwwwwwwwwwwwwwwwwwww